A

    abgo - encircle, go around/about - ymbgan
    ablie - lie around - ymblicgan
    abwind - envelop (by winding round) - ymbwinden
    acraft - devise - acræftan
    afear - terrify, make afraid - afæran
    afterfollow - succeed - æfterfolgian
    afterfollowedness - sequel - æfterfylgednes
    afterfollower - successor - æfterfylgere
    aftergoer - descendant - æftergenga
    aftergoingness - posterity - æftergengnes
    afterwardness - posterity - æfterwardnes
    aftnewing - restoration - eftniwung
    alease - redeem, save - aliesan
    aleaseness - redemption - alesnis
    aliken - compare - anlician
    anleth - face - andwlita
    anew - to renew - edniwian
    anewed - renewed - edneowe
    angbreast - asthma - angbreost
    angsomely - painfully - angsumlice
    angsomeness - distress, pain - angsumnes
    applewine - cider - æppelwin
    atgo - approach
    atsake - deny - ætsacen
    awayen - repudiate - awægan
    ayewhither - in all directions - æghwider

B

    backboard - port-side, larboard - bæcbord
    bebid - order, command - bebod
    bedrink - absorb - bedrincan
    befare - travel round - befaran
    befasten - apply, entrust, use - befæstan
    befold - enfold - befolden
    begang - circuit - begong
    bego - go around - began
    behideness - conealment - behydnes
    beholdness - observation - behealdnes
    behovely - necessary
    belaugh - deride - behlyhhan
    belean - restrain, dissuade - belean
    bepeach - deceive, delude - bepæcan
    beride - ride round - beridan
    berow - row round - berowan
    beshow - exhibit - besceawian
    beshower - exhibitor - besceawere
    beshowing - exhibition - besceawung
    besink - submerge - besincan
    besit - occupy - besittan
    besorrow - regret - besargian
    besorrowing - compassion - besargung
    bettering - improvement - beterung
    bethink - to consider - beþencan
    betrap - entrap - betræppan
    bewarp - to pervert - beweorpan
    bewend - to convert, turn - bewend
    bewixset - interposed
    bework - to construct - bewyrccan
    bewrite - copy out - bewritan
    birther - fetus
    blitheness - mirth, joy - bliðnes
    bookcraft - book production, design a.s.f. - boccræft
    bookhouse - library - bookhus
    borough - city
    borrowbreach - failure to repay loan - borgbryce
    breastwhelm - powerful emotion, grief - breostwylm
    bridegift - dowry - brydgifu
    busen - example

C

    candletree - candelabrum - candeltreow

D

    dearworth - precious - deorwurþ
    dearworthness - preciousness, treasure - deorwyrþness
    deemer/deemster - a judge (Manx law has deemsters) - dema

E

    earthkin - human race - eorðcyn
    eatgiver - host at a meal - ætgiefa
    elddom - age - ealddom
    elderborough - metropolis
    eldfather - grandfather - ealdfæder
    eldmother - grandmother - ealdmodor
    eldright - ancient right, tradition - ealdriht
    eldsay - tradition (spoken) - ealdgesegen
    endbirthly - in order, in succession, orderly manner - endebyrdlic
    endbirthness - order, series, succession, arrangement, degree - endebyrdnes
    endlessness - infinity, eternity - endeleasnes
    endspeak - epilogue - endespæc
    enoughsome - sufficient, abundant - genyhtsum
    enoughsomeness - sufficiency, abundance - genyhtsumnis
    ettin - giant - eotan
    evenlatcher - immitator - efenlæcan
    evenlatching - immitation - efenlæcung
    evenliness - equality - efenlicnes
    evenlotter - equal sharer, partaker - efenhlytta
    evennight - equinox - efniht
    evenold - contemporary - efneald
    evensorrowing - compassion - efensargung
    evensorry - compassionate - efensarig
    evilwill(ed) - malevolent - yfelwille
    evenworth - equivalent - efenweorð

F

    fakedeed - facendæd
    fakeful - deceitful - facenful
    fakeless - without deceit - facenleas
    fakely - facenlic
    farness - distance - feornes
    feedness - nourishment - fednes
    fewness - paucity - feanes
    fieldly - rural - feldlic
    folkfree - uninhabited - folcfrig
    folkland - common land - folcland
    folkly - public, popular, populous - folclic
    folkright - human/common right, generally accepted - folcriht
    folkish - of the people, secular - folcisc
    forbow - decline (turn down) - forbugan
    forbuilding - encouragement - forbylding
    forcouth - notorious, despicable - forcuð
    fordim - to obscure - fordimman
    fordeem - prejudice, prematurely deem - fordeman
    fordeemer - accuser - fordemend
    fordo - destroy, spoil, ruin - fordon
    forebody - thorax, chest - foranbodig
    forebusy - to preoccupy - forebisegian
    forechoose - prefere - foreceosan
    forecome - to block, prevent move/action, prevent - forecuman
    foregang - precede - foregangan
    foregearing - preparation - foregearwung
    foregoer - predecessor - foregenga
    forehouse - porch - forehus
    forelook - preview - foreloc
    foresay - proclaim - foresecgan
    foreset - propose - forsettan
    foresetness - proposition - foresetnes
    foreshieldness - protection - forescieldnes
    foreshowing - a preview - foresceawung
    forestand - block, prevent - forestandan
    forestep - precede - foresteppan
    forethoughtful - prudent - foreðancful
    forewriteness - prescription - forewritennes
    forfare - obstruct, block - forfaran
    forgively - excusable - forgifenly
    forgoedness - abstention - forgægednes
    forharry - ravage - forhergian
    forharrying - devastation, raid - forheriung
    forhave - abstain, relinquish - forhabban
    forhaveness - abstinence - forhæfnes
    forlead - to seduce - forlæden
    forlet - relinquish, abandon - forlætan
    forletness - remission, abandonment - forletnis
    forlie - perjure - forleogan
    forride - intercept with vehicle/horse a.s.f. - forridan
    forrot - corrode - forrotian
    forsakeness - rejection, abandonment - forsæcennes
    forshape - transform - forscieppan
    forspeak - favour, advocate - forspæc
    forspeaker - sponsor, advocate - forspeca
    forspeech - advocacy - forspæc
    forspend - squander - forspendan
    forspoken - advocated - foresprecan
    forstand - block, prevent, obstruct - forstandan
    forswey - ignore, pass in silence - forswigian
    forthbear - produce - forþberan
    forthbuild - encouragement
    forthbring - accomplish, achieve - forðbrengan
    forthen - promote
    forthing - advancement
    forthfatheren - paternal
    forthfroming - departure - forðfromung
    forthly - advanced - forþlic
    forthspell - declaration
    forthway - departure - forþweg
    forthshaft - future - forðgesceaft
    forthstepping - advance - forðstæpping
    forthyearnful - impetuous - forðgeorn
    fortrueing - presumption - fortruwung
    forwardness - progress - forðweardnes
    forwork - forfeit, ruin, undo/destroy effort, labour/work - forwyrcan
    forworth - be ruined - forweorðan
    forworthness - devaluation - forweorðenes
    foryield - recompense, requite - forgieldan
    frameful - constructive, positive - fremful
    framefully - constructively, positively - fremfulic
    frimdy - curious, inquisitive - frymdig
    frith - peace - friþ
    fromfare - departure - framfær
    frithstow - reseve (f.e.wildlife) - friþstowe
    fullframe - to complete - fullfremman
    fullframed - completed - fulfremed
    fullframedly - completely - fullfremedlice
    fullframedness - completion - fulfremednes
    fullgo - complete (such as duration of time) - fullgan
    fullsomeness - abundance - fulsumnes
    fullwork - complete (such as a task, construction, action) - fulwyrcan

G

    gatheredness - abscess - gegaderednes
    gatheringly - collectively - gadrigendlic
    gearingness - preparation - gearwungnes
    guestlithe - hospitable - giestliðe
    guestlitheness - hospitality - giestliðnes

H

    harmshare - punishment - hearmscearu
    Harvestmonth - September - Hærfesmonað
    haveless - destitute - hafenleas
    headand - captain
    headly - principal, capital - heafodlic
    hean - abject, despised - hean
    heanly - base, despicable, low - heanlic
    healness - salvation - hælnes
    hearsome - attentive - hiersum
    hearsomeness - attentiveness - hiersumnes
    heavytime - oppressive - hefigtyme
    hinderness - hindrance - hindernes
    highberg - mountain - héahbeorg
    hipboneache - sciatica - hypebanece
    hoardvat - coffer - hordfæt
    holdness - observance - healdnes
    holdsome - economical - healdsum
    holdsomeness - preservation, restraint, custody - healdsumnes
    hotheartedness - ardour - hatheortnes
    huebright - brightly coloured - hiwbeorht
    hueless - colourless - hiwleas
    hungerbitten - starvation

I

    idleyearnful - indolent - idelgeorn
    inbequeath - to inculcate - inbecqeðan
    indrink - imbibe - indrincan
    infare - incursion - infare
    infleshness - incarnation - inflescnes
    ingoer - visitor - ingenga
    ingoing - entrance - ingang
    inheaten - to inflame - inhætan
    inlead - introduce - inlædan
    inlighten - enlighten - inlihtan
    inlightness - enlightenment - inlihtnes
    inly - internally - inlic
    inning - content - innung
    inset - institute - insettan
    insetness - institution, regulation - insetnes
    inshowing - inspection - insceawung
    inthink - intention - ingeþanc
    inwitness - conscience, consciousness - ingewitness
    inwriting - inscription - inwritting

K

    kinly - pertaining to family/kin - cynlic

L

    landfee - ground-rent - londfeoh
    landfolk - native- londfolc
    lessness - minority - leasnes
    likeworthy - acceptable, nice, likeable - licwerþe
    likeworthily - licwyrþlice
    likeworthiness - licwyrþnes
    longsome - tedious - langsum
    longsomely - tediously - langsumlic
    longsomeness - tediousness - langsumnes

M

    manifoldly - (from manifold=multiply/multiple)- manigfealdlic
    manifoldness - multiplicity, abundance, complexity - manigfealdnes
    midfastness - moderation - midfæstnes
    midmost - most central - midmest
    middlest - most central (superlative of middle) - midlest
    Midsummermonth - June - Midsumermonað
    mightly - possible - mihtelic
    mildheart(ed)ness - (meaning obvious) - mildheortnes
    mindlyness - rememberance - myndiglicnes
    mindworth - worth remembering/minding - gemyndwyrðe
    misbirth - miscarriage - misbyrd
    misborn - degenerate - misboren
    misdo - do incorrectly/wrongly, transgress - misdon
    mislikeness - dissimilarity, difference - mislicneyss
    moonly - lunar - monlic
    moonsick - lunatic - monseoc
    moory - abounding in moors - morig
    mouthroof - palate - muðhrof
    mousehawk - buzzard - mushafoc
    muchness - size - micelnes

N

    needly - necessary - nydlic
    needness - necessity - nydnes

O

    oathbreach - perjury - aðbryce
    offdo - remove - ofdon
    offgive - relinquish, release to, abandon - ofgiefan
    offlet - relinquish - oflætan
    offthink - digress - ofþyncan
    oldness - old age - ealdnyss
    onbeload - inflict on - onbelædan
    onbeshowing - examination - onbesceawung
    onbide - expect, await - onbidan
    onehood - unity
    onfind - discover, notice - onfindan
    onfoundness - experience - onfundennys
    onget - notice, perceive - ongietan
    ongetful - perceptive - andgietful
    ongetfully - perceptively - andgitfullice
    ongetless - lacking perception - andgietless
    ongetness - perception - ongietennes
    onlease - release - onlysan
    onlighten - illuminate - onlihtan
    onshot - attack (f.e. by shooting, also spoken) - onscyte
    onsong - incantation - onsang
    onthereto - in addition, additionally - on þærto
    ourlandish - of this country - urelandisc
    outgoing - exit, exodus - utgong
    outkind - extraneous - utacund
    overfare - travel over - overfaran
    overfindness - experiment - oferfundenness
    overflowness - superfluity - oferflownes
    overlive - survive - oferlibban
    overlove - (meaning obvious) - oferlufu
    overmoodyness - (meaning obvious) - ofermodignes
    overwork - superstructure - ofergeweorc
    ownwilled - agnes willan

P

    plight - danger
    plightful - dangerous

R

    readly - expedient - rædlic
    reeve - official - rieff
    righting - correction - rihting
    rightwise- just, in a correct way - rihtwis
    righwiseness - justice, righteousness - rihtwisnyss
    roomheart(ed) - generous - rumheort
    rootfast - firmly established - rotfæst
    roughmood - (meaning obvious) - hreohmod

S

    sealy - maritime, marine - sælic
    scathe - injure - sceaððan
    scatheful - injurious - sceaðful
    scatheness - injury - sceaððignes
    searim - coast - særima
    seenly - visible - gesiendlic
    seldly - rare - seldlic
    selfdom - independence - selfdom
    selfly - egotistic - selflic
    selfmurder(ing) - suicide - selfmyrðrung
    selfmurderer - one who takes own life - selfmyrðra
    setness - foundation, composition, settlement, arrangement - setness
    shadewise - rational - sceadwis
    shadewiseness - discretion, discrimination - sceadwisnes
    shandful - disgraceful - scandful
    shandliness - disgrace - scandlicnes
    shandly - scandlic
    shielder - protector scildend
    shieldness - protection - scildnes
    shoting - missile - scotung
    sidely - descrete - sidelic
    slithe - cruel, savage - sliðen
    smalling - atrophy - smalung
    smathinkly - in detail - smeaðanclic
    sorrowly - miserable - sorglic
    sorrowleath (n) - lament - sorgleoð
    sparstone - gypsum - spærstan
    stead - place, location - stede
    steerer - director - steorend
    steerless - profligate, out of control - steorleas
    steerlessly - profligately, unmanageably - steorleaslic
    steerspeech - guidance (spoken) - steorsprec
    stevven - voice - stemn
    stirness - commotion - styrenes
    stovebath - sauna - stofbæð
    suchness - nature, reality, quality - swelcnes
    sunderfreedom - privilege - sundorfreodom
    sundering - division - ásyndrung
    sunderly - special - sundorlic
    sunly - solar - sunlic

T

    thankworthy - acceptable, pleasing - þoncwyrðe
    thoughting - consideration, deliberation - þeahtung
    thrithely - excellent - þryþlic
    throughdrench - to saturate - þurhdrencan
    throughholed - pierced, holed - þurhholod
    throughlooking - perusal - þurhlocung
    throughseek - to research - þurhsecan
    throughwone - persist, continue - þurhwunian
    tokening - significant
    trueless - false - treowleas
    truelessness - falsehood - treowleasnes
    twofoldly - doubly - twifealdlic
    twofoldness - duplication - twifealdnes
    twowordy - ambiguous - twiwyrdig

U

    unbearinglike - intolerable - unaberendlic
    unbefought - uncontested - unbefohten
    underbear - support - underberan
    underdriveness - subjection - underdrifenness
    underget - perceive - undergietan
    underseek - investigate - undersecan
    underthink - meditate - underðencan
    unforcouth - not notorious, without dishonour - unforcuþ
    unframeful - negative - unfremful
    unfrith - hostility - unfriþ
    unfulframing - incompletion - unfulfremming
    unhold - disloyal - unhold
    unlored - ignorant - ungelæred
    unmightly - impossibile - unmihtlic
    unmightlyness - impossibility - unmihtilicnys
    unrightwise - unjust - unrihtwis
    unrightwiseness - injustice, iniquity - unrehtwisnis
    unstillness - movement, disturbance - unstilness
    undtidely - unreasonable
    untholing - intolerable
    untodealed -undivided
    untrimness - (infirmity) state of not being trim - untrymnes
    unwinsome - unpleasant - unwinsum
    unwinsomeness - unpleasantness - unwinsumnes
    upariseness - resurrection - uparisnes
    upgoing - ascent - upgang

W

    wedbreach - divorce, adultery - wedbryce
    welwilling - (meaning obvious)- welwillende
    welwillingly - (meaning obvious)- welwillendlic
    welwillingness - (meaning obvious)- welwillendnes
    whelm - surge, fervour - wylm
    whilewendly - temporary, transitory - hwilwendlic
    widegoing - itinerant, widely travelled - widgenge
    wilsomeness - state of being voluntary - wilsumnes
    winsomeness - pleasure, delight - wynsumnes
    witherchoose - reject, change choice, deselect - wiðerceosan
    witherling - opponent, adversary - wiðerling
    withersake - adversary - wiþersaca
    witherspeaker - contradictor - wiðersprecend
    witherward - contrary, opposite - wiðerweard
    witherwardly - contrarily, inimically - wiðerweardlic
    witherwardness - opposition - wiðerweardnes
    withgo - vanish, disappear - wiðgan
    withleadness - abduction by leading off - wiþlædniss
    withsake - renounce - wiðsacan
    withsay - to renounce - wiðsecgan
    withsetness - opposition - wiðsetnes
    woetoken - portent, sign of misfortune - weatacn
    wordful - fluent - wordful
    wordhoard - vocabulary
    wordlock - words fitting together to make sense, logic - wordloc
    wordlore - etymology - wordlar
    wordmark - definition - wordgemearc
    wordwinsome - affable, happy to talk - wordwynsum
    wordwrestle - debate, argue, discuss - wordum wrixlan
    workcraft - mechanics - weorccræft
    workness - operation - weorcnes
    worldshame - great or public disgrace - woroldscamu
    worthful - valuable - weorðful

Y

    yearnful - full of yearning - geornful
    yearnfulness - state of being yearnful - geornfulnes
    yearnfully - geornfulic -
    yelpword - boast - gielpword
    yetsing - avarice, covetousness, desire - gitsung
    yondfare - travel to a place away - geondfaran
    yondlighten - illuminate - geondlyhtan
    yondsend - distribute - geondsendan
    yondshow - reveal, open to scrutinization - geondsceawian
    yondthink - contemplate - geondþencan
    youthhood - adolescence - geoguþhad
